10.@H
@.@.......
.......@..
..........
......@...
..........
..........
......@...
..........
..........
...@......
...@......
