20.@H
....................
....................
...............@@...
....................
...........@........
....@......@.......@
....................
....................
.@..........@.......
....................
....@...............
.....................
.......@............
.@..................
......@.@.......@@..
..............@.....
.@..@...............
....................
...............@.@@.
....................
