10.@H
..@.......
..........
.......@@.
..@....@..
..........
..........
.....x....
..........
..........
..........
